XXXXXXXXXX
XXXXXXXXXX
XXXXXXXXXX
..........
..........
..........
....E.....
XXXXXXXXXX
XXXXXXXXXX
XXXXXXXXXX
