XXXX..XXXX
XXX....XXX
XX......XX
X........X
..........
..........
XXXXXXXXXX
XXXXXXXXXX
XXXXXXXXXX
XXXXXXXXXX
