XXXXXXXXXX
XXXXXXXXXX
XXXXXXXXXX
.XXXXXXXX.
..XXXXXX..
...XXXX...
....XX....
X........X
XX......XX
XXX....XXX
