XXX....XXX
XX......XX
X........X
....XX....
...XXXX...
..XXXXXX..
.XXXXXXXX.
XXXXXXXXXX
XXXXXXXXXX
XXXXXXXXXX
