XXXXXXXXXX
XXX....XXX
XX......XX
X..XXXX..X
..XXXXXX..
.XXXXXXXX.
XXXXXXXXXX
XXXXXXXXXX
XXXXXXXXXX
XXXXXXXXXX
