XXXXXXXXXX
XXXX..XXXX
XXX....XXX
XX......XX
X........X
X........X
XX......XX
XXX....XXX
XXXX..XXXX
XXXXXXXXXX
