XXXXXXXXXX
XX......XX
X........X
..........
..........
..........
..........
X........X
XX......XX
XXX....XXX
