XXX....XXX
XXX....XXX
XXX....XXX
..........
..........
..........
..........
XXXXXXXXXX
XXXXXXXXXX
XXXXXXXXXX
