XXXXXXXXXX
XXXXXXXXXX
XXXXXXXXXX
XXXXXXXXXX
.XXXXXXXX.
..XXXXXX..
X..XXXX..X
XX..XX..XX
XXX....XXX
XXXX..XXXX
