XXXXXXXXXX
XXXXXXXXXX
XXXXXXXXXX
..........
..........
..........
....S.....
XXXXXXXXXX
XXXXXXXXXX
XXXXXXXXXX
