XXXXXXXXXX
XXX....XXX
XX......XX
..........
..........
..........
..........
XX......XX
XXX....XXX
XXXXXXXXXX
