XXXXXXXXXX
XXXXXXXXXX
XXXXXXXXXX
.XXXXXXXX.
..XXXXXX..
...XXXX...
..........
X........X
XX......XX
XXXXXXXXXX
