XXX...XXXX
XXXX...XXX
XXX...XXXX
XXXX...XXX
..........
..........
XXXXXXXXXX
XXXXXXXXXX
XXXXXXXXXX
XXXXXXXXXX
