XXXXXXXXXX
XXXXXXXXXX
XXXXXXXXXX
XXXXXXXXXX
.XXXXXXXX.
..XXXXXX..
X..XXXX..X
XX......XX
XXX....XXX
XXXXXXXXXX
