XXXXXXXXXX
XXXXXXXXXX
XXXXXXXXXX
XXXXXXXXXX
..........
..........
XXXX...XXX
XXX...XXXX
XXXX...XXX
XXX...XXXX
