XXXXXXXXXX
XXXXXXXXXX
XXXXXXXXXX
XXXXXXXXXX
..........
..........
X........X
XX......XX
XXX....XXX
XXXX..XXXX
