XXXXXXXXXX
XXXXXXXXXX
XXXXXXXXXX
..........
..........
..........
..........
XXX....XXX
XXX....XXX
XXX....XXX
