XXXXXXXXXX
XX......XX
X........X
..........
...XXXX...
..XXXXXX..
.XXXXXXXX.
XXXXXXXXXX
XXXXXXXXXX
XXXXXXXXXX
