XXXX..XXXX
XXX....XXX
XX..XX..XX
X..XXXX..X
..XXXXXX..
.XXXXXXXX.
XXXXXXXXXX
XXXXXXXXXX
XXXXXXXXXX
XXXXXXXXXX
